CLTS_NAME	BIPA_GRAPHEME	FREQUENCY	GRAPHEME
voiceless alveolar click consonant	ǃ	173	!
aspirated voiceless alveolar click consonant	ǃʰ	262	!ʰ
breathy voiceless alveolar click consonant	ǃʱ	178	!ʱ
glottalized voiceless alveolar click consonant	ǃˀ	255	!ˀ
glottalized aspirated voiceless alveolar click consonant	ǃʰˀ	231	!ˀʰ
unrounded open front vowel	a	154	a
long unrounded open front vowel	aː	151	aː
breathy unrounded open front vowel	a̤	147	a̤
creaky unrounded open front vowel	a̰	155	a̰
voiced bilabial stop consonant	b	641	b
from voiced bilabial stop to voiced alveolar stop cluster	bd	669	bd
from voiced bilabial stop to voiced dental implosive cluster	bɗ	703	bɗ
from voiced bilabial stop to voiced alveolar lateral fricative cluster	bɮ	461	bɮ
labialized voiced bilabial stop consonant	bʷ	612	bʷ
glottalized voiced bilabial stop consonant	bˀ	591	bˀ
breathy voiced bilabial stop consonant	bʱ	652	b̤
creaky voiced bilabial stop consonant	b̰	637	b̰
voiced bilabial affricate consonant	bβ	77	bᵝ
voiceless palatal stop consonant	c	642	c
aspirated voiceless palatal stop consonant	cʰ	685	cʰ
palatalized voiceless palatal stop consonant	cʲ	476	cʲ
palatalized labialized voiceless palatal stop consonant	cʲʷ	469	cʲʷ
palatalized long voiceless palatal stop consonant	cʲː	473	cʲː
labialized voiceless palatal stop consonant	cʷ	485	cʷ
glottalized voiceless palatal stop consonant	cˀ	626	cˀ
long voiceless palatal stop consonant	cː	681	cː
long voiceless palatal stop consonant	cː	480	cːː
devoiced voiceless palatal stop consonant	c̥	470	c̥
voiceless palatal sibilant fricative consonant	ç	324	ç
long voiceless palatal sibilant fricative consonant	çː	391	çː
voiced alveolar stop consonant	d	643	d
palatalized voiced alveolar stop consonant	dʲ	574	dʲ
glottalized voiced alveolar stop consonant	dˀ	570	dˀ
with-lateral-release voiced alveolar stop consonant	dˡ	52	dˡ
breathy voiced alveolar stop consonant	dʱ	631	d̤
voiced dental stop consonant	d̪	589	d̪
breathy voiced dental stop consonant	d̪ʱ	675	d̪̤
creaky voiced alveolar stop consonant	d̰	603	d̰
voiced dental affricate consonant	dð	116	dᶞ
voiced alveolar sibilant affricate consonant	dz	78	dᶻ
unrounded close-mid front vowel	e	400	e
breathy unrounded close-mid front vowel	e̤	404	e̤
creaky unrounded close-mid front vowel	ḛ	414	ḛ
voiceless labio-dental fricative consonant	f	337	f
aspirated voiceless labio-dental fricative consonant	fʰ	362	fʰ
labialized voiceless labio-dental fricative consonant	fʷ	333	fʷ
glottalized voiceless labio-dental fricative consonant	fˀ	388	fˀ
voiceless glottal fricative consonant	h	338	h
palatalized voiceless glottal fricative consonant	hʲ	387	hʲ
labialized voiceless glottal fricative consonant	hʷ	372	hʷ
unrounded close front vowel	i	401	i
breathy unrounded close front vowel	i̤	402	i̤
retracted unrounded close front vowel	i̠	399	i̱
voiced palatal approximant consonant	j	418	j
glottalized voiced palatal approximant consonant	jˀ	426	jˀ
devoiced voiced palatal approximant consonant	j̊	419	j̥
voiceless velar stop consonant	k	648	k
from voiceless velar stop to voiceless bilabial stop cluster	kp	580	kp
from voiceless velar stop to labialized voiceless bilabial stop cluster	kpʷ	664	kpʷ
from voiceless velar stop to voiceless alveolar stop cluster	kt	582	kt
aspirated voiceless velar stop consonant	kʰ	640	kʰ
labialized aspirated voiceless velar stop consonant	kʷʰ	644	kʰʷ
palatalized voiceless velar stop consonant	kʲ	680	kʲ
labialized voiceless velar stop consonant	kʷ	560	kʷ
glottalized voiceless velar stop consonant	kˀ	608	kˀ
palatalized glottalized voiceless velar stop consonant	kʲˀ	698	kˀʲ
labialized glottalized voiceless velar stop consonant	kʷˀ	700	kˀʷ
long voiceless velar stop consonant	kː	655	kː
with-lateral-release voiceless velar stop consonant	kˡ	14	kˡ
glottalized with-lateral-release voiceless velar stop consonant	kˀˡ	25	kˡˀ
voiceless velar affricate consonant	kx	123	kˣ
voiced alveolar lateral approximant consonant	l	439	l
palatalized voiced alveolar lateral approximant consonant	lʲ	464	lʲ
glottalized voiced alveolar lateral approximant consonant	lˀ	459	lˀ
syllabic voiced alveolar lateral approximant consonant	l̩	462	ḷ
breathy voiced alveolar lateral approximant consonant	lʱ	443	l̤
devoiced voiced alveolar lateral approximant consonant	l̥	456	l̥
voiced dental lateral approximant consonant	l̪	453	l̪
devoiced voiced dental lateral approximant consonant	l̪̥	436	l̪̥
voiced bilabial nasal consonant	m	524	m
breathy voiced bilabial nasal consonant	mʱ	536	mʱ
labialized voiced bilabial nasal consonant	mʷ	530	mʷ
glottalized voiced bilabial nasal consonant	mˀ	540	mˀ
with-lateral-release voiced bilabial nasal consonant	mˡ	513	mˡ
breathy voiced bilabial nasal consonant	mʱ	555	m̤
devoiced voiced bilabial nasal consonant	m̥	529	m̥
with-lateral-release devoiced voiced bilabial nasal consonant	m̥ˡ	551	m̥ˡ
voiced alveolar nasal consonant	n	525	n
voiced alveolar nasal consonant	n	214	n/n
breathy voiced alveolar nasal consonant	nʱ	520	nʱ
palatalized voiced alveolar nasal consonant	nʲ	539	nʲ
labialized voiced alveolar nasal consonant	nʷ	557	nʷ
glottalized voiced alveolar nasal consonant	nˀ	531	nˀ
syllabic voiced alveolar nasal consonant	n̩	528	ṇ
devoiced voiced alveolar nasal consonant	n̥	516	n̥
voiced dental nasal consonant	n̪	556	n̪
devoiced voiced dental nasal consonant	n̪̥	514	n̪̥
rounded close-mid back vowel	o	130	o
breathy rounded close-mid back vowel	o̤	133	o̤
creaky rounded close-mid back vowel	o̰	142	o̰
voiceless bilabial stop consonant	p	657	p
from voiceless bilabial stop to voiceless alveolar stop cluster	pt	701	pt
aspirated voiceless bilabial stop consonant	pʰ	597	pʰ
breathy voiceless bilabial stop consonant	pʱ	577	pʱ
labialized voiceless bilabial stop consonant	pʷ	654	pʷ
glottalized voiceless bilabial stop consonant	pˀ	667	pˀ
long voiceless bilabial stop consonant	pː	573	pː
with-lateral-release voiceless bilabial stop consonant	pˡ	111	pˡ
aspirated with-lateral-release voiceless bilabial stop consonant	pʰˡ	50	pˡʰ
voiceless labio-dental affricate consonant	pf	120	pᶠ
voiceless bilabial affricate consonant	pɸ	58	pᶲ
voiceless uvular stop consonant	q	658	q
aspirated voiceless uvular stop consonant	qʰ	587	qʰ
labialized aspirated voiceless uvular stop consonant	qʷʰ	617	qʰʷ
labialized voiceless uvular stop consonant	qʷ	702	qʷ
glottalized voiceless uvular stop consonant	qˀ	690	qˀ
labialized glottalized voiceless uvular stop consonant	qʷˀ	594	qˀʷ
voiceless uvular affricate consonant	qχ	51	qᵡ
voiced alveolar trill consonant	r	713	r
palatalized voiced alveolar trill consonant	rʲ	732	rʲ
glottalized voiced alveolar trill consonant	rˀ	710	rˀ
devoiced voiced alveolar trill consonant	r̥	731	r̥
voiced dental trill consonant	r̪	730	r̪
voiceless alveolar sibilant fricative consonant	s	343	s
aspirated voiceless alveolar sibilant fricative consonant	sʰ	300	sʰ
palatalized voiceless alveolar sibilant fricative consonant	sʲ	326	sʲ
labialized voiceless alveolar sibilant fricative consonant	sʷ	313	sʷ
glottalized voiceless alveolar sibilant fricative consonant	sˀ	306	sˀ
long voiceless alveolar sibilant fricative consonant	sː	376	sː
voiceless dental sibilant fricative consonant	s̪	319	s̪
glottalized long voiceless dental sibilant fricative consonant	s̪ˀː	328	s̪ːˀ
voiceless alveolar stop consonant	t	661	t
from voiceless alveolar stop to voiceless bilabial stop cluster	tp	649	tp
aspirated voiceless alveolar stop consonant	tʰ	569	tʰ
breathy voiceless alveolar stop consonant	tʱ	684	tʱ
palatalized voiceless alveolar stop consonant	tʲ	625	tʲ
glottalized voiceless alveolar stop consonant	tˀ	627	tˀ
long voiceless alveolar stop consonant	tː	593	tː
long with-lateral-release voiceless alveolar stop consonant	tˡː	11	tːˡ
glottalized long with-lateral-release voiceless alveolar stop consonant	tˀˡː	68	tːˡˀ
with-lateral-release voiceless alveolar stop consonant	tˡ	90	tˡ
aspirated with-lateral-release voiceless alveolar stop consonant	tʰˡ	104	tˡʰ
glottalized with-lateral-release voiceless alveolar stop consonant	tˀˡ	62	tˡˀ
with-lateral-release devoiced voiceless alveolar stop consonant	t̥ˡ	10	tˡ̥
aspirated with-lateral-release devoiced voiceless alveolar stop consonant	t̥ʰˡ	49	tˡ̥ʰ
voiceless alveolar sibilant affricate consonant	ts	98	tˢ
voiceless dental stop consonant	t̪	565	t̪
aspirated voiceless dental stop consonant	t̪ʰ	682	t̪ʰ
labialized voiceless dental stop consonant	t̪ʷ	695	t̪ʷ
glottalized voiceless dental stop consonant	t̪ˀ	679	t̪ˀ
voiceless dental affricate consonant	tθ	18	tᶿ
rounded close back vowel	u	132	u
breathy rounded close back vowel	ṳ	136	ṳ
retracted rounded close back vowel	u̠	135	u̱
voiced labio-dental fricative consonant	v	347	v
aspirated voiced labio-dental fricative consonant	vʰ	398	vʰ
labialized voiced labio-dental fricative consonant	vʷ	294	vʷ
glottalized voiced labio-dental fricative consonant	vˀ	512	vˀ
long voiced labio-dental fricative consonant	vː	491	vː
long creaky voiced labio-dental fricative consonant	v̰ː	487	vː̰
voiced labio-dental tap consonant	ⱱ	501	v̆
devoiced voiced labio-dental fricative consonant	v̥	504	v̥
creaky voiced labio-dental fricative consonant	v̰	510	v̰
long creaky voiced labio-dental fricative consonant	v̰ː	503	v̰ː
voiced labialized-velar approximant consonant	w	424	w
glottalized voiced labialized-velar approximant consonant	wˀ	430	wˀ
devoiced voiced labialized-velar approximant consonant	w̥	423	w̥
voiceless velar fricative consonant	x	350	x
aspirated voiceless velar fricative consonant	xʰ	378	xʰ
labialized voiceless velar fricative consonant	xʷ	375	xʷ
glottalized voiceless velar fricative consonant	xˀ	299	xˀ
labialized glottalized voiceless velar fricative consonant	xʷˀ	349	xˀʷ
rounded close front vowel	y	407	y
voiced alveolar sibilant fricative consonant	z	352	z
breathy voiced alveolar sibilant fricative consonant	zʱ	383	zʱ
labialized voiced alveolar sibilant fricative consonant	zʷ	355	zʷ
glottalized voiced alveolar sibilant fricative consonant	zˀ	331	zˀ
voiced dental sibilant fricative consonant	z̪	351	z̪
palatalized voiced dental sibilant fricative consonant	z̪ʲ	360	z̪ʲ
unrounded nearly-open front vowel	æ	403	æ
voiced dental fricative consonant	ð	293	ð
palatalized voiced dental fricative consonant	ðʲ	334	ðʲ
rounded close-mid front vowel	ø	406	ø
voiceless pharyngeal fricative consonant	ħ	297	ħ
voiced velar nasal consonant	ŋ	553	ŋ
palatalized voiced velar nasal consonant	ŋʲ	548	ŋʲ
labialized voiced velar nasal consonant	ŋʷ	523	ŋʷ
glottalized voiced velar nasal consonant	ŋˀ	527	ŋˀ
devoiced voiced velar nasal consonant	ŋ̊	559	ŋ̥
palatalized devoiced voiced velar nasal consonant	ŋ̥ʲ	550	ŋ̥ʲ
labialized devoiced voiced velar nasal consonant	ŋ̥ʷ	521	ŋ̥ʷ
rounded open-mid front vowel	œ	412	œ
voiceless lateral click consonant	ǁ	230	ǁ
aspirated voiceless lateral click consonant	ǁʰ	239	ǁʰ
breathy voiceless lateral click consonant	ǁʱ	289	ǁʱ
glottalized voiceless lateral click consonant	ǁˀ	225	ǁˀ
glottalized aspirated voiceless lateral click consonant	ǁʰˀ	281	ǁˀʰ
voiceless palatal click consonant	ǂ	186	ǂ
aspirated voiceless palatal click consonant	ǂʰ	177	ǂʰ
breathy voiceless palatal click consonant	ǂʱ	210	ǂʱ
glottalized voiceless palatal click consonant	ǂˀ	284	ǂˀ
glottalized aspirated voiceless palatal click consonant	ǂʰˀ	234	ǂˀʰ
unrounded nearly-open central vowel	ɐ	145	ɐ
unrounded open back vowel	ɑ	139	ɑ
non-syllabic unrounded open back vowel	ɑ̯	427	ɑ̯
rounded open back vowel	ɒ	134	ɒ
voiced bilabial implosive consonant	ɓ	602	ɓ
labialized voiced bilabial implosive consonant	ɓʷ	671	ɓʷ
rounded open-mid back vowel	ɔ	137	ɔ
breathy rounded open-mid back vowel	ɔ̤	127	ɔ̤
voiced dental implosive consonant	ɗ	697	ɗ
unrounded mid central vowel	ə	148	ə
breathy unrounded mid central vowel	ə̤	153	ə̤
non-syllabic unrounded mid central vowel	ə̯	417	ə̯
unrounded open-mid front vowel	ɛ	410	ɛ
breathy unrounded open-mid front vowel	ɛ̤	409	ɛ̤
voiced palatal stop consonant	ɟ	606	ɟ
voiced velar implosive consonant	ɠ	639	ɠ
voiced velar stop consonant	g	662	ɡ
voiced alveolar click consonant	gǃ	263	ɡ!
glottalized aspirated voiced alveolar click consonant	gǃʰˀ	250	ɡ!ˀʰ
voiced alveolar nasal consonant	n	156	ɡ/n
from voiced velar stop to voiced bilabial stop cluster	gb	576	ɡb
from voiced velar stop to labialized voiced bilabial stop cluster	gbʷ	663	ɡbʷ
from voiced velar stop to voiced alveolar stop cluster	gd	578	ɡd
voiced lateral click consonant	gǁ	249	ɡǁ
glottalized aspirated voiced lateral click consonant	gǁʰˀ	286	ɡǁˀʰ
voiced palatal click consonant	gǂ	235	ɡǂ
glottalized aspirated voiced palatal click consonant	gǂʰˀ	224	ɡǂˀʰ
voiced labial click consonant	gʘ	258	ɡʘ
palatalized voiced velar stop consonant	gʲ	677	ɡʲ
labialized voiced velar stop consonant	gʷ	610	ɡʷ
glottalized voiced velar stop consonant	gˀ	670	ɡˀ
long voiced velar stop consonant	gː	691	ɡː
labialized long voiced velar stop consonant	gʷː	590	ɡːʷ
creaky voiced velar stop consonant	g̰	699	ɡ̰
voiced velar fricative consonant	ɣ	303	ɣ
labialized voiced velar fricative consonant	ɣʷ	295	ɣʷ
unrounded close-mid back vowel	ɤ	131	ɤ
voiced labialized-palatal approximant consonant	ɥ	432	ɥ
voiced glottal fricative consonant	ɦ	354	ɦ
unrounded close central vowel	ɨ	150	ɨ
breathy unrounded close central vowel	ɨ̤	144	ɨ̤
non-syllabic unrounded close central vowel	ɨ̯	422	ɨ̯
voiceless alveolar lateral fricative consonant	ɬ	444	ɬ
aspirated voiceless alveolar lateral fricative consonant	ɬʰ	434	ɬʰ
glottalized voiceless alveolar lateral fricative consonant	ɬˀ	440	ɬˀ
long voiceless alveolar lateral fricative consonant	ɬː	445	ɬː
voiceless dental lateral fricative consonant	ɬ̪	457	ɬ̪
voiced alveolar lateral fricative consonant	ɮ	454	ɮ
unrounded close back vowel	ɯ	128	ɯ
unrounded close back with_rising_tone vowel	ɯ̌	138	ɯ̌
non-syllabic unrounded close back vowel	ɯ̯	425	ɯ̯
voiced labio-dental nasal consonant	ɱ	534	ɱ
rounded close-mid central vowel	ɵ	152	ɵ
voiceless bilabial fricative consonant	ɸ	394	ɸ
palatalized voiceless bilabial fricative consonant	ɸʲ	368	ɸʲ
labialized voiceless bilabial fricative consonant	ɸʷ	341	ɸʷ
glottalized voiceless bilabial fricative consonant	ɸˀ	332	ɸˀ
voiced alveolar approximant consonant	ɹ	715	ɹ
devoiced voiced alveolar approximant consonant	ɹ̥	716	ɹ̥
devoiced voiced alveolar tap consonant	ɾ	720	ɾ
voiced uvular fricative consonant	ʁ	725	ʁ
labialized voiced uvular fricative consonant	ʁʷ	344	ʁʷ
glottalized voiced uvular fricative consonant	ʁˀ	359	ʁˀ
voiced palatal implosive consonant	ʄ	566	ʄ
rounded close central vowel	ʉ	146	ʉ
rounded near-close near-back vowel	ʊ	143	ʊ
breathy rounded near-close near-back vowel	ʊ̤	141	ʊ̤
unrounded open-mid back vowel	ʌ	129	ʌ
voiced palatal lateral approximant consonant	ʎ	450	ʎ
devoiced voiced palatal lateral approximant consonant	ʎ̥	463	ʎ̥
voiceless glottal stop consonant	ʔ	564	ʔ
aspirated voiceless glottal stop consonant	ʔʰ	646	ʔʰ
palatalized voiceless glottal stop consonant	ʔʲ	686	ʔʲ
labialized voiceless glottal stop consonant	ʔʷ	592	ʔʷ
voiced pharyngeal fricative consonant	ʕ	305	ʕ
labialized voiced pharyngeal fricative consonant	ʕʷ	327	ʕʷ
glottalized voiced pharyngeal fricative consonant	ʕˀ	340	ʕˀ
labialized glottalized voiced pharyngeal fricative consonant	ʕʷˀ	396	ʕˀʷ
voiceless labial click consonant	ʘ	247	ʘ
aspirated voiceless labial click consonant	ʘʰ	291	ʘʰ
breathy voiceless labial click consonant	ʘʱ	221	ʘʱ
glottalized voiceless labial click consonant	ʘˀ	292	ʘˀ
rounded close with-frication back vowel	ʮ	345	ʮ
glottalized rounded close with-frication back vowel	ʮˀ	374	ʮˀ
long rounded close with-frication back vowel	ʮː	307	ʮː
rounded close with-frication central vowel	ʯ	365	ʯ
glottalized rounded close with-frication central vowel	ʯˀ	316	ʯˀ
pre-aspirated voiced alveolar stop consonant	ʰd	615	ʰd
pre-aspirated voiceless velar stop consonant	ʰk	622	ʰk
pre-aspirated voiceless bilabial stop consonant	ʰp	630	ʰp
pre-aspirated voiceless alveolar stop consonant	ʰt	633	ʰt
pre-glottalized voiced bilabial stop consonant	ˀb	604	ˀb
pre-glottalized with-lateral-release voiced bilabial stop consonant	ˀbˡ	70	ˀbˡ
pre-glottalized voiceless palatal stop consonant	ˀc	466	ˀc
pre-glottalized voiced alveolar stop consonant	ˀd	607	ˀd
pre-glottalized voiced dental stop consonant	ˀd̪	647	ˀd̪
pre-glottalized voiceless glottal fricative consonant	ˀh	317	ˀh
pre-glottalized voiced palatal approximant consonant	ˀj	421	ˀj
pre-glottalized voiceless velar stop consonant	ˀk	613	ˀk
pre-glottalized voiced alveolar lateral approximant consonant	ˀl	446	ˀl
pre-glottalized voiced bilabial nasal consonant	ˀm	532	ˀm
pre-glottalized voiced alveolar nasal consonant	ˀn	535	ˀn
pre-glottalized voiced dental nasal consonant	ˀn̪	522	ˀn̪
pre-glottalized voiceless bilabial stop consonant	ˀp	620	ˀp
pre-glottalized voiced alveolar trill consonant	ˀr	719	ˀr
pre-glottalized voiceless dental sibilant fricative consonant	ˀs̪	361	ˀs̪
pre-glottalized voiceless alveolar stop consonant	ˀt	624	ˀt
pre-glottalized aspirated voiceless dental stop consonant	ˀt̪ʰ	694	ˀt̪ʰ
pre-glottalized voiced labio-dental fricative consonant	ˀv	323	ˀv
pre-glottalized voiced labialized-velar approximant consonant	ˀw	428	ˀw
pre-glottalized voiced alveolar sibilant fricative consonant	ˀz	325	ˀz
pre-glottalized voiced dental fricative consonant	ˀð	335	ˀð
pre-glottalized voiced velar nasal consonant	ˀŋ	552	ˀŋ
pre-glottalized labialized voiced velar nasal consonant	ˀŋʷ	526	ˀŋʷ
pre-glottalized voiced palatal stop consonant	ˀɟ	636	ˀɟ
pre-glottalized voiced velar fricative consonant	ˀɣ	314	ˀɣ
pre-glottalized devoiced voiced alveolar tap consonant	ˀɾ	737	ˀɾ
pre-glottalized voiced uvular fricative consonant	ˀʁ	364	ˀʁ
pre-glottalized labialized voiced uvular fricative consonant	ˀʁʷ	358	ˀʁʷ
voiced bilabial fricative consonant	β	336	β
palatalized voiced bilabial fricative consonant	βʲ	315	βʲ
labialized voiced bilabial fricative consonant	βʷ	373	βʷ
pre-nasalized voiced alveolar stop consonant	ⁿd	581	ⁿd
pre-nasalized palatalized voiced alveolar stop consonant	ⁿdʲ	600	ⁿdʲ
pre-nasalized with-lateral-release voiced alveolar stop consonant	ⁿdˡ	79	ⁿdˡ
pre-nasalized voiced dental stop consonant	ⁿd̪	687	ⁿd̪
pre-nasalized voiceless alveolar sibilant fricative consonant	ⁿs	308	ⁿs
pre-nasalized voiceless alveolar stop consonant	ⁿt	596	ⁿt
pre-nasalized aspirated voiceless alveolar stop consonant	ⁿtʰ	595	ⁿtʰ
pre-nasalized glottalized with-lateral-release voiceless alveolar stop consonant	ⁿtˀˡ	55	ⁿtˡˀ
pre-nasalized voiced alveolar sibilant fricative consonant	ⁿz	312	ⁿz
pre-nasalized devoiced voiced alveolar tap consonant	ⁿɾ	705	ⁿɾ
